教师ID	oid	整数
所在学校	school_id	整数
教师资格证号	certified_no	字符
身份证号	id_card	字符
文化程度	edu_level	整数
毕业学校	graduate_school	字符
所学专业	specialty	字符
毕业时间	graduation_time	时间日期
照片	photo_url	字符
婚姻状况	marriage_code	整数
性别	sex	整数
出生日期	birthday	日期
名族	folk_code	整数
国籍	nativePlace_code	整数
人员来源	orgin_type	整数
户籍所在地	residence_address	字符
参加工作时间	join_time	整数
政治面貌	politics_code	整数
联系电话	phone	字符
所属部门	dept_id	整数
主教学科	bishop_subject	整数
职称	positional_title	整数
编制	approve	整数
状态	status	整数
排序	row_sort	整数
备注	summary	字符
创建用户	create_user	整数
创建时间	create_time	日期时间
更新用户	update_user	整数
更新时间	update_time	日期时间
